11 15
|-------------|
|.FP|...|...|P|
|.--..|.@.|...|
|.F..|..-.|.|.|
|.-.--.-..|..-|
|.......|...-.|
|-.---.|..-.-.|
|...|....|.F..|
|P|...-|...-.-|
|...|....-...P|
|-------------|
